00000000000000000000000000000000000000000000000000000000
00000000000000000000000000000000000000000000000000000000
00000000000000000000000000000000000000000000000000000000
00000000000000000000000000000000000000000000000000000000
00000000000000000000000500000000000000000000000000000000
00000000000000000000000000001000000000000000000000000000
00000000000000000555000000002000000000000000000000000000
00000000000000000000000000002111100000000111110000000000
00000000000000000000000000002000122222222100000000000000
00000000000000000000000000002000000000000000000000040000
11111110005555555555555551111000000000000000000000111000
00000000000000000000000000000000000000000000000000000000
00000000000000000000000000000000000000000000000000000000
00000000000000000000000000000000000000000000000000000000
00000000000000000000000000000000000000000000000000000000