1111111111111111111111111111111111111111111111111111111111111111111111111111111111111111111111111
1111000000000000000000000000000000000000000000000000000000001111111111111111111111111111111111111
1111000000000000000000000000000000000000000000000000000000001111111111111111111111111111111111111
1111000000000000000000000000000000000000000000000000000000001111111111111111111111111111111111111
1111111111111111111111111100111111111111111111111111100111111111111111111111111111111111111111111
1111111111111111111111111100111111111111111111111111100111111111111111111111111111111111111111111
1111111111111111111111111100111111111111111111110000000000000000000000000000000000000000000001111
1111111111111111111111111100111111111111111111100000000000000000000000000000000000000000000001111
1111111111111111111111111100111111111111111111000000000000000000000000000000000000000000000001111
1111111111111111111111111100111111111111111111000533333111111111110011111111111111111111110001111
1111111111111111111111111100111111111111111110005111111111111111110011111111111111111111110001111
1100000000000000000000000000111111111111111100051111111111111111110011111111111111111111110001111
1100000000000000000000000000111111111111111000511111111111111111110011111111111111111111110001111
1100000000000000000000000000111111111111110005111111111111111111110000000000000000000000000001111
1155555555500555555555555522111111111111100051111111111111111111110000000000000000000000000001111
1111111111100111111111111122111111111111000511111111111111111111110000000000000000000000000001111
1111111111100111111111111111111111111110005111111111111111111111110011111111111111111111112221111
1111111111100000000000000000000000000000051111111111111111111111110000000000000000000000000001111
1111111111100000000000000000000000000000511111111111111111111111110000000000000000000000000001111
1111111111100000000000000000000000000005111111111111111111111111110000000000000000000000000401111
1111111111100555555555555555555555555551111111111111111111111111112211111111111111111111111111111