0000000000000000000000000000000000000000000000000000000000000000000000000000000000000000000000000000000000000000000000000000000000000000000000000000000000000000000000000000
0000000000000000000000000000000000000000000000000000000000000000000000000000000000000000000000000000000000000000000000000000000000000000000000000000000000000000000000000000
0000000000000000000000000000000000000000000000000000000000000000000000000000000000000000000000000000000000000000000000000000000000000000000000000000000000000000000000000000
0000000000000000000000000000000000000000000000000000000000000000000000000000000000000000000000000000000000000000000000000000000000000000000000000000000000000000000000000000
0000000000000000000200000000000000200000000000000000000000000000000000000000002000000000000000200000000000000003000000000000000000000000000000000000000000000000000000000000
0000000000000000000200000000000000200000000000000000000000000000000000000000002000000000000000200000000000000003000000000000000020000000000002000000000000000200000000000000
0000000000000200000200000030000000200000003000000000200033000000222000003000002000000030000000200000000200000003000000000020000020000030000002000000030000000200000300000000
0000000000000200000000000030000000000000003000000000200033000000000000003000000000000030000000000000000200000000000000000220000000000030000002200000030000000200000300000000
0000000000000200000000000030000000000000003000000000200000000000000000003000000000000030000000000000000200000000000000000220000000000030000000000000030000000000000300004000
1110055555555555555555555555555555555555555555555111555555555555555555555555555555555555555555555555555555555555555555555555555555555555555555555555555555555555555555511000
0000000000000000000000000000000000000000000000000000000000000000000000000000000000000000000000000000000000000000000000000000000000000000000000000000000000000000000000000000